#######################################
#.....................................#
#.....................................#
#....#######..........................#
#.................................#...#
#.................................#...#
#.................................#...#
#.....................#############...#
#.................................#...#
#.................................#...#
#.................................#...#
#..........######.................#...#
#...............#.................#...#
#...............#.................#...#
#...............#.................#...#
#...............##############....#...#
#.....................................#
#.....................................#
#.....................................#
#.....................................#
#...#............#..........#.........#
#....#...........#..........#.........#
#.....#..........#..........#.........#
#......#.........#..........#.........#
#.......#........#..........#.........#
#................#..........#.........#
#...........................#.........#
#.....................................#
########################.....#........#
#......................#.....#........#
#......................#.....#........#
#............................#........#
#............................#........#
#..........###################........#
#.....................................#
#.....................................#
#.....................................#
#.....................................#
#######################################
